Species_name	Comments_bernat	H	O
Ablepharus pannonicus	HAJARS_no_endem	0	1
Acanthodactylus blanfordii	Genus Hajars	0	1
Acanthodactylus boskianus asper	HAJARS_no_endem	0	1
Acanthodactylus opheodurus	HAJARS_no_endem	0	1
Acanthodactylus schmidti	Genus Hajars	0	1
Acanthosaura lepidogaster	Backbone	0	1
Acrochordus granulatus	Backbone	0	1
Alopoglossus angulatus	Backbone	0	1
Anguis fragilis	Backbone	0	1
Aprasia parapulchella	Backbone	0	1
Asaccus andersoni	Genus Hajars	0	1
Asaccus arnoldi	Hajars	1	0
Asaccus caudivolvulus	Hajars	1	0
Asaccus elisae	Genus Hajars	0	1
Asaccus gallagheri	Hajars	1	0
Asaccus gardneri	Hajars	1	0
Asaccus granularis	Genus Hajars	0	1
Asaccus griseonotus	Genus Hajars	0	1
Asaccus iranicus	Genus Hajars	0	1
Asaccus kermanshahensis	Genus Hajars	0	1
Asaccus kurdistanensis	Genus Hajars	0	1
Asaccus margaritae	Hajars	1	0
Asaccus montanus	Hajars	1	0
Asaccus nasrullahi	Genus Hajars	0	1
Asaccus platyrhynchus	Hajars	1	0
Asaccus tangestanensis	Genus Hajars	0	1
Asaccus zagrosicus	Genus Hajars	0	1
Anilius scytale	Backbone	0	1
Anniella pulchra	Backbone	0	1
Anolis carolinensis	Backbone	0	1
Bunopus blanfordii	de Pous J27	0	1
Bunopus crassicauda	Genus Hajars	0	1
Bunopus tuberculatus	Genus Hajars	0	1
Aspidoscelis tigris	Backbone	0	1
Bipes canaliculatus	Backbone	0	1
Carphodactylus laevis	Backbone	0	1
Blanus strauchi	Backbone	0	1
Cadea blanoides	Backbone	0	1
Calotes versicolor	Backbone	0	1
Casarea dussumieri	Backbone	0	1
Celestus enneagrammus	Backbone	0	1
Cerastes cerastes	HAJARS_no_endem	0	1
Cerastes gasperettii	HAJARS_no_endem	0	1
Cerastes vipera	HAJARS_no_endem	0	1
Chalarodon madagascariensis	Backbone	0	1
Dibamus novaeguineae	Backbone	0	1
Chalcides ocellatus	HAJARS_no_endem	0	1
Chamaeleo calyptratus	Backbone	0	1
Colobosaura modesta	Backbone	0	1
Corytophanes cristatus	Backbone	0	1
Ctenophorus adelaidensis	Backbone	0	1
Cylindrophis ruffus	Backbone	0	1
Daboia russelii	Backbone	0	1
Diplometopon zarudnyi	Backbone	0	1
Dipsosaurus dorsalis	Backbone	0	1
Echis borkini	Genus Hajars	0	1
Echis carinatus	Genus Hajars	0	1
Echis coloratus	Genus Hajars	0	1
Echis jogeri	Genus Hajars	0	1
Eublepharis macularius	Backbone	0	1
Echis khosatzkii	Genus Hajars	0	1
Echis leucogaster	Genus Hajars	0	1
Echis ocellatus	Genus Hajars	0	1
Echis omanensis	Hajars	1	0
Echis pyramidum	Genus Hajars	0	1
Enyalioides laticeps	Backbone	0	1
Eryx jayakari	Backbone	0	1
Gallotia bravoana	Backbone	0	1
Gallotia caesaris caesaris	Backbone	0	1
Gallotia caesaris gomerae	Backbone	0	1
Gallotia galloti eisentrauti	Backbone	0	1
Hemidactylus adensis	Genus Hajars	0	1
Hemidactylus afarensis	Genus Hajars	0	1
Hemidactylus albopunctatus	Genus Hajars	0	1
Hemidactylus alfarraji	Genus Hajars	0	1
Hemidactylus alkiyumii	Genus Hajars	0	1
Hemidactylus angulatus	Genus Hajars	0	1
Hemidactylus asirensis	Genus Hajars	0	1
Hemidactylus awashensis	Genus Hajars	0	1
Hemidactylus barbierii	Genus Hajars	0	1
Hemidactylus barodanus	Genus Hajars	0	1
Hemidactylus brasilianus	Genus Hajars	0	1
Hemidactylus citernii	Genus Hajars	0	1
Hemidactylus dawudazraqi	Genus Hajars	0	1
Hemidactylus dracaenacolus	Genus Hajars	0	1
Hemidactylus fasciatus	Genus Hajars	0	1
Hemidactylus festivus	Genus Hajars	0	1
Hemidactylus flaviviridis	Genus Hajars	0	1
Hemidactylus forbesii	Genus Hajars	0	1
Hemidactylus foudaii	Genus Hajars	0	1
Hemidactylus frenatus	Genus Hajars	0	1
Hemidactylus funaiolii	Genus Hajars	0	1
Hemidactylus granchii	Genus Hajars	0	1
Hemidactylus granosus	Genus Hajars	0	1
Hemidactylus granti	Genus Hajars	0	1
Hemidactylus hajarensis	Hajars	1	0
Hemidactylus homoeolepis	Genus Hajars	0	1
Hemidactylus imbricatus	Genus Hajars	0	1
Hemidactylus inexpectatus	Genus Hajars	0	1
Hemidactylus inintellectus	Genus Hajars	0	1
Hemidactylus isolepis	Genus Hajars	0	1
Hemidactylus jumailiae	Genus Hajars	0	1
Hemidactylus kurdicus	Genus Hajars	0	1
Hemidactylus laevis	Genus Hajars	0	1
Hemidactylus lanzai	Genus Hajars	0	1
Hemidactylus lavadeserticus	Genus Hajars	0	1
Hemidactylus lemurinus	Genus Hajars	0	1
Hemidactylus longicephalus	Genus Hajars	0	1
Hemidactylus luqueorum	Hajars	1	0
Hemidactylus mabouia	Genus Hajars	0	1
Hemidactylus macropholis	Genus Hajars	0	1
Hemidactylus mandebensis	Genus Hajars	0	1
Hemidactylus masirahensis	Genus Hajars	0	1
Hemidactylus mindiae	Genus Hajars	0	1
Hemidactylus minutus	Genus Hajars	0	1
Hemidactylus montanus	Genus Hajars	0	1
Hemidactylus ophiolepis	Genus Hajars	0	1
Hemidactylus ophiolepoides	Genus Hajars	0	1
Hemidactylus oxyrhinus	Genus Hajars	0	1
Hemidactylus palaichthus	Genus Hajars	0	1
Hemidactylus pauciporosus	Genus Hajars	0	1
Hemidactylus paucituberculatus	Genus Hajars	0	1
Hemidactylus persicus	Genus Hajars	0	1
Hemidactylus platycephalus	Genus Hajars	0	1
Hemidactylus platyurus	Genus Hajars	0	1
Hemidactylus pumilio	Genus Hajars	0	1
Hemidactylus robustus	Genus Hajars	0	1
Hemidactylus ruspolii	Genus Hajars	0	1
Hemidactylus saba	Genus Hajars	0	1
Hemidactylus shihraensis	Genus Hajars	0	1
Hemidactylus sinaitus	Genus Hajars	0	1
Hemidactylus smithi	Genus Hajars	0	1
Hemidactylus somalicus	Genus Hajars	0	1
Hemidactylus squamulatus	Genus Hajars	0	1
Hemidactylus triedrus	Genus Hajars	0	1
Hemidactylus turcicus	Genus Hajars	0	1
Hemidactylus ulii	Genus Hajars	0	1
Hemidactylus yerburii	Genus Hajars	0	1
Gallotia galloti palmae	Backbone	0	1
Gallotia intermedia	Backbone	0	1
Gallotia simonyi	Backbone	0	1
Gambelia wislizenii	Backbone	0	1
Geocalamus acutus	Backbone	0	1
Gerrhopilus mirus	Backbone	0	1
Heloderma suspectum	Backbone	0	1
Homalopsis buccata	Backbone	0	1
Hydrosaurus amboinensis	Backbone	0	1
Indotyphlops braminus	Backbone	0	1
Intellagama lesueurii	Backbone	0	1
Lanthanotus borneensis	Backbone	0	1
Leiocephalus barahonensis	Backbone	0	1
Leiolepis belliana	Backbone	0	1
Liotyphlops albirostris	Backbone	0	1
Loxocemus bicolor	Backbone	0	1
Lytorhynchus diadema	Backbone	0	1
Macrovipera lebetina	Backbone Eastern mediterranean	0	1
Malayopython reticulatus	Backbone	0	1
Malpolon moilensis	Backbone	0	1
Naultinus gemmeus	Backbone	0	1
Oedodera marmorata	Backbone	0	1
Mesalina adramitana	Genus Hajars	0	1
Mesalina austroarabica	Genus Hajars	0	1
Mesalina brevirostris	Genus Hajars	0	1
Myriopholis macrorhyncha	Backbone	0	1
Phelsuma inexpectata	Backbone	0	1
Phelsuma ornata	Backbone	0	1
Naja kaouthia	Backbone	0	1
Naja nigricollis	Backbone	0	1
Namazonurus namaquensis	Backbone	0	1
Omanosaura cyanura	Hajars	1	0
Omanosaura jayakari	Hajars	1	0
Pareas carinatus	Backbone	0	1
Petrosaurus mearnsi	Backbone	0	1
Phrynosoma cornutum	Backbone	0	1
Phymaturus palluma	Backbone	0	1
Pristurus abdelkuri	Genus Hajars	0	1
Pristurus adrarensis	Genus Hajars	0	1
Pristurus carteri	Genus Hajars	0	1
Pristurus celerrimus	Hajars	1	0
Pristurus collaris	Genus Hajars	0	1
Pristurus crucifer	Genus Hajars	0	1
Pristurus flavipunctatus	Genus Hajars	0	1
Pristurus gallagheri	Hajars	1	0
Pristurus guichardi	Genus Hajars	0	1
Pristurus insignis	Genus Hajars	0	1
Pristurus insignoides	Genus Hajars	0	1
Pristurus masirahensis	Genus Hajars	0	1
Pristurus minimus	Genus Hajars	0	1
Pristurus obsti	Genus Hajars	0	1
Pristurus ornithocephalus	Genus Hajars	0	1
Pristurus phillipsii	Genus Hajars	0	1
Pristurus popovi	Genus Hajars	0	1
Pristurus rupestris	Hajars	1	0
Pristurus samhaensis	Genus Hajars	0	1
Pristurus sokotranus	Genus Hajars	0	1
Pristurus somalicus	Genus Hajars	0	1
Pristurus sp1	Genus Hajars	0	1
Pristurus sp10	Genus Hajars	0	1
Pristurus sp11	Genus Hajars	0	1
Pristurus sp12	Genus Hajars	0	1
Pristurus sp2	Hajars	1	0
Pristurus sp3	Hajars	1	0
Pristurus sp4	Hajars	1	0
Pristurus sp5	Hajars	1	0
Pristurus sp6	Genus Hajars	0	1
Pristurus sp7	Genus Hajars	0	1
Pristurus sp8	Genus Hajars	0	1
Pristurus sp9	Genus Hajars	0	1
Platyceps  rhodorachis	HAJARS_no_endem	0	1
Plica plica	Backbone	0	1
Podarcis lilfordi	Backbone	0	1
Podarcis pityusensis	Backbone	0	1
Pogona vitticeps	Backbone	0	1
Polychrus marmoratus	Backbone	0	1
Porthidium arcosae	Backbone	0	1
Porthidium nasutum	Backbone	0	1
Ptyodactylus ananjevae	Genus Hajars	0	1
Ptyodactylus dhofarensis	Genus Hajars	0	1
Ptyodactylus guttatus	Genus Hajars	0	1
Ptyodactylus hasselquistii	Genus Hajars	0	1
Ptyodactylus orlovi	Hajars	1	0
Ptyodactylus oudrii	Genus Hajars	0	1
Ptyodactylus puiseuxi	Genus Hajars	0	1
Ptyodactylus ragazzii	Genus Hajars	0	1
Ptyodactylus ruusaljibalicus	Hajars	1	0
Ptyodactylus siphonorhina	Genus Hajars	0	1
Ptyodactylus sp. 1	Genus Hajars	0	1
Ptyodactylus sp. 2	Genus Hajars	0	1
Ptyodactylus sp. 3	Genus Hajars	0	1
Ptyodactylus sp. 4	Genus Hajars	0	1
Ptyodactylus sp. 5	Genus Hajars	0	1
Ptyodactylus togoensis	Genus Hajars	0	1
Rhacodactylus leachianus	Backbone	0	1
Psammodromus algirus	Backbone	0	1
Psammophis schokari	Backbone	0	1
Pseudocerastes persicus	HAJARS_no_endem	0	1
Pseudotrapelus aqabensis	Genus Hajars	0	1
Sphaerodactylus elegans	Backbone	0	1
Sphaerodactylus macrolepis	Backbone	0	1
Sphenodon punctatus	Backbone	0	1
Teratoscincus keyserlingii	backbone	0	1
Trachydactylus hajarensis	Hajars	1	0
Trachydactylus spatalurus	Genus Hajars	0	1
Pseudotrapelus chlodnickii	Genus Hajars	0	1
Pseudotrapelus dhofarensis	Genus Hajars	0	1
Pseudotrapelus jensvindumi	Hajars	1	0
Pseudotrapelus neumanni	Genus Hajars	0	1
Woodworthia maculatus	Backbone	0	1
Pseudotrapelus sinaitus	Genus Hajars	0	1
Rhineura floridana	Backbone	0	1
Rhinophis drummondhayi	Backbone	0	1
Saara hardwickii	Backbone	0	1
Scincus mitranus	HAJARS_no_endem	0	1
Scincus scincus conirostris	HAJARS_no_endem	0	1
Shinisaurus crocodilurus	Backbone	0	1
Stenodactylus leptocosymbotes	HAJARS_no_endem	0	1
Trogonodactylus arabicus	HAJARS_no_endem	0	1
Trogonodactylus sharqiyahensis	HAJARS_no_endem	0	1
Stenodactylus doriae	HAJARS_no_endem	0	1
Spalerosophis diadema cliffordii	HAJARS_no_endem	0	1
#REF!	HAJARS_no_endem	0	1
Trachylepis tessellata	HAJARS_no_endem	0	1
Trapelus flavimaculatus	HAJARS_no_endem	0	1
Trapelus boehmei	Backbone	0	1
Tropidophis haetianus	Backbone	0	1
Uromastyx aegyptia aegyptia	HAJARS_no_endem	0	1
Uromastyx aegyptia leptieni	HAJARS_no_endem	0	1
Uromastyx aegyptia microlepis	HAJARS_no_endem	0	1
Uromastyx benti	HAJARS_no_endem	0	1
Uromastyx nigriventris	HAJARS_no_endem	0	1
Uromastyx ornata philbyi	HAJARS_no_endem	0	1
Uromastyx thomasi	HAJARS_no_endem	0	1
Cyrtopodion scabrum	HAJARS_no_endem	0	1
Urostrophus vautieri	Backbone	0	1
Uta stansburiana	Backbone	0	1
Varanus griseus	Backbone	0	1
Varanus mertensi	HAJARS_no_endem	0	1
Varanus mitchelli	HAJARS_no_endem	0	1
Varanus salvator	HAJARS_no_endem	0	1
Xantusia vigilis	Backbone	0	1
Xenodermus javanicus	Backbone	0	1
Xenopeltis unicolor	Backbone	0	1
Xenosaurus grandis	Backbone	0	1
Xenotyphlops grandidieri	Backbone	0	1
Zonosaurus ornatus	Backbone	0	1